Burka	Bur
brunetka	brunet
założycielka	założyciel
szkopka	szkop
Warmiaczka	Warmiak
panczenistka	panczenista
grafomanka	grafoman
katowiczanka	katowiczanin
urzędniczka wysokiego szczebla	urzędnik wysokiego szczebla
mysłowiczanka	mysłowiczanin
dewiantka	dewiant
nauczycielka	nauczyciel
wynajmująca	wynajmujący
dygnitarka	dygnitarz
Somalijka	Somalijczyk
noworuska	noworuski
rychliczanka	rychliczanin
daltonistka	daltonista
parweniuszka	parweniusz
powódka	powód
orędowniczka	orędownik
formalistka	formalista
chórmistrzyni	chórmistrz
menelka	menel
łapaczka	łapacz
gnieźnianka	gnieźnianin
miliarderka	miliarder
pudlica	pudel
grubaska	grubas
bibliografka	bibliograf
austrofilka	austrofil
bukmacherka	bukmacher
kucharka	kucharz
olsztynianka	olsztynianin
frustratka	frustrat
Semitka	Semita
przestępczyni	przestępca
andrychowianka	andrychowianin
taryfiara	taryfiarz
siódmoklasistka	siódmoklasista
fordanserka	fordanser
lalkarka	lalkarz
higienistka	higienista
Maurytyjka	Maurytyjczyk
korespondentka	korespondent
bidula	bidak
Tyrolka	Tyrolczyk
wszystkowidząca	wszystkowidzący
dłużniczka	dłużnik
bulimiczka	bulimik
rutyniara	rutyniarz
awanturniczka	awanturnik
Argentynka	Argentyńczyk
Lombardka	Lombardczyk
pięcioboistka nowoczesna	pięcioboista nowoczesny
poławiaczka	poławiacz
mieszczka	mieszczanin
lojalistka	lojalista
Inguszka	Ingusz
wyborczyni	wyborca
karmelarka	karmelarz
strojnisia	strojniś
chałturzystka	chałturzysta
dziadówa	dziad
dereszowata	dereszowaty
wędrowniczka	wędrownik
celtolożka	celtolog
kulturystka	kulturysta
Kambodżanka	Kambodżanin
najemniczka	najemnik
obrażalska	obrażalski
pokrzywdzona	pokrzywdzony
piechurka	piechur
Maja	Maj
zabójczyni	zabójca
idiotka	idiota
sabotażystka	sabotażysta
wnuczka	wnuczek
gniada	gniady
doktórka	doktór
syndykalistka	syndykalista
delegatka	delegat
judoczka	judoka
sztangistka	sztangista
Burundyjka	Burundyjczyk
domowniczka	domownik
kapitalistka	kapitalista
Kujawianka	Kujawianin
zapominalska	zapominalski
dochtórka	dochtór
sprzedawczyni	sprzedawca
hipoterapeutka	hipoterapeuta
filosemitka	filosemita
swatka	swat
Babilonka	Babilończyk
Trynidadka	Trynidadczyk
szpadzistka	szpadzista
dostawczyni	dostawca
kandydatka	kandydat
Karelka	Karel
bojowniczka	bojownik
blogerka	bloger
rehabilitantka	rehabilitant
Łotyszka	Łotysz
gaździna	gazda
lisica	lis
eksperymentatorka	eksperymentator
wdowa	wdowiec
ankieterka	ankieter
nędzarka	nędzarz
biała	biały
Mohikanka	Mohikanin
liryczka	liryk
instrumentariuszka	instrumentariusz
essenka	esseńczyk
Krakowianka	Krakowiak
tricolorka	tricolor
Brytyjka	Brytyjczyk
reemigrantka	reemigrant
testatorka	testator
interlokutorka	interlokutor
głównodowodząca	głównodowodzący
braniewianka	braniewianin
rodzimowierczyni	rodzimowierca
pedofilka	pedofil
Dominikanka	Dominikańczyk
powieściopisarka	powieściopisarz
gramatyczka	gramatyk
zarządzająca	zarządzający
krytyczka	krytyk
ponuraczka	ponurak
winna	winny
lekarka	lekarz
hawanka	hawańczyk
Włoszka	Włoch
Rzymianka	Rzymianin
genuenka	genueńczyk
charakteropatka	charakteropata
gołębica	gołąb
purystka	purysta
zstępna	zstępny
filantropka	filantrop
arabka	arab
kawoszka	kawosz
gierałtowiczanka	gierałtowiczanin
protoplastka	protoplasta
ascetka	asceta
tanecznica	tanecznik
papieżyca	papież
florecistka	florecista
ałmatka	ałmatczyk
luksemburka	luksemburczyk
Saracenka	Saracen
Gujanka	Gujańczyk
zakładniczka	zakładnik
beletryzatorka	beletryzator
humanitarystka	humanitarysta
alfonska	alfons
guwernantka	guwerner
poręczycielka	poręczyciel
pingwinica	pingwin
monterka	monter
układaczka	układacz
introwertyczka	introwertyk
instruktorka	instruktor
pośredniczka	pośrednik
histeryczka	histeryk
spadochroniarka	spadochroniarz
golaska	golas
rzecznik prasowa	rzecznik prasowy
dekoratorka	dekorator
kresowianka	kresowianin
prostaczka	prostak
Kastylka	Kastylczyk
aparatka	aparat
młoda	młody
intendentka	intendent
Wołoszka	Wołoch
kompilatorka	kompilator
japonistka	japonista
piłkarka ręczna	piłkarz ręczny
smarkula	smarkul
Malajka	Malaj
zbawczyni	zbawca
synobójczyni	synobójca
listonoszka	listonosz
rzeźbiarka	rzeźbiarz
rewelatorka	rewelator
chałturniczka	chałturnik
klonowianka	klonowianin
raperka	raper
protegowana	protegowany
Surinamka	Surinamczyk
zatrzymana	zatrzymany
ekonomistka	ekonomista
czerwonoarmistka	czerwonoarmista
złodziejka	złodziej
kronikarka	kronikarz
deblistka	deblista
Numidyjka	Numida
realistka	realista
racjonalistka	racjonalista
tytanida	tytan
basistka	basista
sześciolatka	sześciolatek
Ruska	Ruski
insynuatorka	insynuator
kantorzystka	kantorzysta
abiturientka	abiturient
zdrajczyni	zdrajca
bazylianka	bazylianin
Andaluzyjka	Andaluzyjczyk
kaznodziejka	kaznodzieja
tolkmiczanka	tolkmiczanin
kosmopolitka	kosmopolita
staruszka	staruszek
brakarka	brakarz
widzka	widz
altowiolinistka	altowiolinista
Sudanka	Sudańczyk
baseballistka	baseballista
Dominiczanka	Dominiczanin
ciemiężycielka	ciemiężyciel
grymaśnica	grymaśnik
katastrofistka	katastrofista
klarnecistka	klarnecista
kacerka	kacerz
chwałowiczanka	chwałowiczanin
inwalidka	inwalida
bohemistka	bohemista
Chaldejka	Chaldejczyk
Honduranka	Honduranin
abderytka	abderyta
asyriolożka	asyriolog
hafciarka	hafciarz
opiekunka	opiekun
kleczewianka	kleczewianin
demonstrantka	demonstrant
cerowaczka	cerowacz
poskromicielka	poskromiciel
obywatelka świata	obywatel świata
towarzyszka broni	towarzysz broni
zakochana	zakochany
Australijka	Australijczyk
balownica	balownik
autonomistka	autonomista
Żmudzinka	Żmudzin
bamberka	bamber
Nowozelandka	Nowozelandczyk
krytykantka	krytykant
dyskutantka	dyskutant
karaimka	karaim
przekupka	przekupień
namiestniczka	namiestnik
taksówkarka	taksówkarz
oblubienica	oblubieniec
Etruska	Etrusk
okularnica	okularnik
epigonka	epigon
śmiertelniczka	śmiertelnik
właścicielka	właściciel
Flamandka	Flamand
jubilatka	jubilat
kokainistka	kokainista
minorytka	minoryta
gongorystka	gongorysta
hokeistka	hokeista
lęborczanka	lęborczanin
prowincjuszka	prowincjusz
zesłana	zesłany
lionka	liończyk
Cyganka	Cygan
perkusistka	perkusista
adeptka	adept
Sycylijka	Sycylijczyk
badylara	badylarz
czyścioszka	czyścioch
próżniaczka	próżniak
siedemdziesięciolatka	siedemdziesięciolatek
bawolica	bawół
krzyżanowiczanka	krzyżanowiczanin
prozaiczka	prozaik
Arabka	Arab
flirciara	flirciarz
sztokholmka	sztokholmczyk
szybowniczka	szybownik
wykwintnisia	wykwintniś
pijaczka	pijak
wstręciucha	wstręciuch
starościna	starosta
wolbromianka	wolbromianin
hołdowniczka	hołdownik
Panamka	Panamczyk
nowojorczanka	nowojorczyk
bajerantka	bajerant
czerniejewianka	Czerniejewo
prozatorka	prozator
pokrzepicielka	pokrzepiciel
czarodziejka	czarodziej
chrześniaczka	chrześniak
plotkarka	plotkarz
triatlonistka	triatlonista
spadkobierczyni	spadkobierca
aukcjonerka	aukcjoner
Zabużanka	Zabużanin
towarzyszka niedoli	towarzysz niedoli
dyktatorka mody	dyktator mody
Afrykanerka	Afrykaner
Andorka	Andorczyk
esesmanka	esesman
wnioskodawczyni	wnioskodawca
boguszowianka	boguszowianin
rodaczka	rodak
Madagaskarka	Madagaskarczyk
chałupniczka	chałupnik
buchalterka	buchalter
dozymetrystka	dozymetrysta
współautorka	współautor
zakrystianka	zakrystian
kantyniarka	kantyniarz
Indianka	Indianin
łobuziara	łobuziak
strukturalistka	strukturalista
szulerka	szuler
biedaczka	biedak
Latynoska	Latynos
prasowaczka	prasowacz
błażowianka	błażowianin
akupunkturzystka	akupunkturzysta
zbawicielka	zbawiciel
recenzentka	recenzent
zamiataczka	zamiatacz
Greczynka	Grek
rówieśniczka	rówieśnik
degeneratka	degenerat
sercanka	sercanin
pracowniczka	pracownik
rzemieślniczka	rzemieślnik
ilustratorka	ilustrator
montażystka	montażysta
ukochana	ukochany
fizylierka	fizylier
bizneswoman	biznesmen
drobiarka	drobiarz
zygotarianka	zygotarianin
czarnoskóra	czarnoskóry
Czukczyjka	Czukcz
woluntariuszka	woluntariusz
skoczkini	skoczek
mahometanka	mahometanin
recytatorka	recytator
deklamatorka	deklamator
kolonistka	kolonista
ergonomistka	ergonomista
dysortograficzka	dysortografik
stara	stary
ankarka	ankarczyk
czyścicielka	czyściciel
donatorka	donator
studentka	student
fonetyczka	fonetyk
muszynianka	muszynianin
informatorka	informator
miła	miły
sodomitka	sodomita
tyszanka	tyszanin
iranistka	iranista
Chinka	Chińczyk
internautka	internauta
matematyczka	matematyk
reflektantka	reflektant
arabistka	arabista
birofilka	birofil
hazardzistka	hazardzista
sojuszniczka	sojusznik
grekokatoliczka	grekokatolik
egocentryczka	egocentryk
skazana	skazany
badylarka	badylarz
śmieszka	śmieszek
performerka	performer
dziewiętnastolatka	dziewiętnastolatek
gołąbka	gołąbek
poległa	poległy
kobyłczanka	kobyłczanin
londynka	londyńczyk
wychowawczyni	wychowawca
grodziszczanka	grodziszczanin
wolontariuszka	wolontariusz
wnuczka	wnuk
alkoholiczka	alkoholik
nieprofesjonalistka	nieprofesjonalista
trzydziestoparolatka	trzydziestoparolatek
cieszynianka	cieszynianin
cyganka	cygan
radczyni	radca
kamerzystka	kamerzysta
umiłowana	umiłowany
czapkarka	czapkarz
abolicjonistka	abolicjonista
gruźliczka	gruźlik
zecerka	zecer
numerantka	numerant
srokata	srokaty
inspicjentka	inspicjent
Tybetanka	Tybetańczyk
santoczanka	santoczanin
domatorka	domator
turkowianka	turkowianin
aresztantka	aresztant
Mezopotamka	Mezopotamczyk
wybawczyni	wybawca
kalwinka	kalwin
pocieszycielka	pocieszyciel
milionerka	milioner
kasztanka	kasztanek
globtroterka	globtroter
tropicielka	tropiciel
prezbiterianka	prezbiterianin
wielbłądzica	wielbłąd
Ghanka	Ghańczyk
anorektyczka	anorektyk
dyskobolka	dyskobol
wygodnisia	wygodniś
jasnowidząca	jasnowidzący
bratanica	brataniec
Anglosaska	Anglosas
bostonka	bostończyk
Khmerka	Khmer
grupowiczka	grupowicz
alergiczka	alergik
Kiribatyjka	Kiribatyjczyk
cesarzowa	cesarz
beneficjentka	beneficjent
aeronautka	aeronauta
marsylianka	marsylianin
siedmiolatka	siedmiolatek
wyspiarka	wyspiarz
Borowiaczka	Borowiak
astygmatyczka	astygmatyk
parolatka	parolatek
drogerzystka	drogerzysta
Karakałpaczka	Karakałpak
podżegaczka	podżegacz
dziwaczka	dziwak
poszkodowana	poszkodowany
biotechnolożka	biotechnolog
filatelistka	filatelista
posterunkowa	posterunkowy
czarna	czarny
spawaczka	spawacz
pątniczka	pątnik
cichociemna	cichociemny
mówczyni	mówca
cenzorka	cenzor
adiutantka	adiutant
słuchaczka	słuchacz
prowokatorka	prowokator
nazistka	nazista
olkuszanka	olkuszanin
redaktorka	redaktor
Mulatka	Mulat
cwaniara	cwaniak
kombinatorka	kombinator
trzeźwa	trzeźwy
optymistka	optymista
małżonka	małżonek
perfekcjonistka	perfekcjonista
architektka	architekt
oławianka	oławianin
kolarka	kolarz
aktorka	aktor
bokserka	bokser
Murzynka	Murzyn
linuksiara	linuksiarz
wróżka	wróż
działaczka	działacz
dawczyni	dawca
Kornwalijka	Kornwalijczyk
Liwijka	Liw
Metyska	Metys
hotelarka	hotelarz
obserwatorka	obserwator
hungarystka	hungarysta
Walijka	Walijczyk
przemytniczka	przemytnik
neofitka	neofita
Nanajka	Nanaj
taksiara	taksiarz
traktorzystka	traktorzysta
bałtystka	bałtysta
epikurejka	epikurejczyk
ministrantka	ministrant
samotniczka	samotnik
ślubna	ślubny
sekretarka	sekretarz
Galicyjka	Galicyjczyk
kitesurferka	kitesurfer
nieznajoma	nieznajomy
powodzianka	powodzianin
poetka	poeta
bałtolożka	bałtolog
rzeczniczka	rzecznik
mieszkanka	mieszkaniec
refrenistka	refrenista
męczennica	męczennik
Antylka	Antylczyk
wróbliczka	wróbel
fałszerka	fałszerz
siedemnastolatka	siedemnastolatek
awangardystka	awangardysta
debiutantka	debiutant
garncarka	garncarz
strasburka	strasburczyk
Podlasiaczka	Podlasiak
magiczka	magik
kawalarka	kawalarz
milanowianka	milanowianin
donosicielka	donosiciel
wuefistka	wuefista
tragiczka	tragik
tarocistka	tarocista
Irokezka	Irokez
pachciarka	pachciarz
poskramiaczka	poskramiacz
Mauretanka	Mauretańczyk
polkowiczanka	polkowiczanin
infantka	infant
guwernerka	guwerner
Mozambijka	Mozambijczyk
baptystka	baptysta
woźna	woźny
przywódczyni	przywódca
osadzona	osadzony
dywersantka	dywersant
laktowegetarianka	laktowegetarianin
ławniczka	ławnik
koloryzatorka	koloryzator
kursantka	kursant
Turkmenka	Turkmen
Portugalka	Portugalczyk
pseudoartystka	pseudoartysta
faworytka	faworyt
utopistka	utopista
nowohucianka	nowohucianin
bukowianka	bukowianin
księżniczka	książę
urbanistka	urbanista
amantka	amant
klawikordzistka	klawikordzista
zakopianka	zakopianin
krykiecistka	krykiecista
bigamistka	bigamista
kanarzyca	kanar
społeczniczka	społecznik
Afrykanka	Afrykanin
głosicielka	głosiciel
akwarystka	akwarysta
współlokatorka	współlokator
miechowianka	miechowianin
artretyczka	artretyk
złoczewianka	złoczewianin
choleryczka	choleryk
terrorystka	terrorysta
czapniczka	czapnik
nerwuska	nerwus
gitarzystka	gitarzysta
sprawozdawczyni	sprawozdawca
szczawniczanka	szczawniczanin
deputowana	deputowany
pierwsza sekretarz	pierwszy sekretarz
Rumunka	Rumun
muzykantka	muzykant
szatanistka	szatanista
niterka	niter
outsiderka	outsider
stewardessa	steward
Kenijka	Kenijczyk
kopistka	kopista
farmerka	farmer
Jemenka	Jemeńczyk
cierpiętnica	cierpiętnik
agentka	agent
Małopolanka	Małopolanin
germanistka	germanista
zwolenniczka	zwolennik
hochsztaplerka	hochsztapler
współproducentka	współproducent
dzieciobójczyni	dzieciobójca
spóźnialska	spóźnialski
hrabini	hrabia
rozrzutnica	rozrzutnik
regalistka	regalista
szabrowniczka	szabrownik
czarnowidzka	czarnowidz
marksistka	marksista
Induska	Indus
degustatorka	degustator
pozytywistka	pozytywista
branżystka	branżysta
makijażystka	makijażysta
dublinka	dublińczyk
stomatolożka	stomatolog
modernistka	modernista
pasjonistka	pasjonista
Czeszka	Czech
rawiczanka	rawiczanin
Szwabka	Szwab
eks	eks
druhna	druh
Rosjanka	Rosjanin
krejzolka	krejzol
koleżanka po piórze	kolega po piórze
cudzoziemka	cudzoziemiec
lekkoatletka	lekkoatleta
subskrybentka	subskrybent
Koreanka	Koreańczyk
Łużyczanka	Łużyczanin
jaślanka	jaślanin
cudaczka	cudak
stołowniczka	stołownik
dyżurna	dyżurny
Sarmatka	Sarmata
negocjatorka	negocjator
nekromantka	nekromanta
autokratka	autokrata
Kongijka	Kongijczyk
oddawczyni	oddawca
adwokatka	adwokat
ćwierćfinalistka	ćwierćfinalista
regentka	regent
wychowanica	wychowanek
technokratka	technokrata
konwojentka	konwojent
metalówa	metalowiec
bojanowianka	bojanowianin
kontrolerka	kontroler
przodownica	przodownik
snajperka	snajper
pracodawczyni	pracodawca
bufonka	bufon
Turczynka	Turczyn
luteranka	luteranin
manipulatorka	manipulator
sznaucerka	sznaucer
dewotka	dewot
eksponentka	eksponent
korwinistka	korwinista
emerytka	emeryt
olbrzymka	olbrzym
ośmioklasistka	ośmioklasista
emigrantka	emigrant
Celtyjka	Celt
eksperymentalistka	eksperymentalista
tyczkarka	tyczkarz
milicjantka	milicjant
klientka	klient
golfistka	golfista
sylfida	sylf
legalistka	legalista
kioskarka	kioskarz
fabrykantka	fabrykant
nowicjuszka	nowicjusz
śluzowa	śluzowy
zaporożanka	zaporożanin
bigorektyczka	bigorektyk
sopocianka	sopocianin
korsarka	korsarz
kociara	kociarz
sympatyczka	sympatyk
Achajka	Achaj
rozgłosicielka	rozgłosiciel
estetka	esteta
bachantka	bachant
ekologistka	ekologista
stronniczka	stronnik
maturzystka	maturzysta
designerka	designer
bałamutnica	bałamutnik
Hinduska	Hindus
aktualistka	aktualista
Brunejka	Brunejczyk
Galilejka	Galilejczyk
suchotnica	suchotnik
moskwiczanka	moskwiczanin
celebrytka	celebryta
siwka	siwek
Zambijka	Zambijczyk
rywalka	rywal
arywistka	arywista
antyfanka	antyfan
przyjezdna	przyjezdny
arcykapłanka	arcykapłan
Lewantynka	Lewantyńczyk
idolka	idol
zwierzchniczka	zwierzchnik
noblistka	noblista
katolka	katol
prowadząca	prowadzący
królewna	królewicz
popularyzatorka	popularyzator
biochemiczka	biochemik
wszechwiedząca	wszechwiedzący
szatanica	szatan
Gaskonka	Gaskończyk
dżokejka	dżokej
protokólantka	protokólant
szwagierka	szwagier
Finlandka	Finlandczyk
agnostyczka	agnostyk
maratonka	maratończyk
lutnistka	lutnista
chlebodawczyni	chlebodawca
klucznica	klucznik
szczypiornistka	szczypiornista
robotniczka	robotnik
reżymówka	reżymowiec
koninianka	koninianin
iberystka	iberysta
Kretenka	Kreteńczyk
neurotyczka	neurotyk
alcistka	alcista
więźniarka	więzień
samarytanka	samarytanin
powierniczka	powiernik
piastowianka	piastowianin
akordeonistka	akordeonista
Czadyjka	Czadyjczyk
ekstremistka	ekstremista
kabalarka	kabalarz
gawędziarka	gawędziarz
sułkowiczanka	sułkowiczanin
ulubienica	ulubieniec
monachijka	monachijczyk
rówiennica	rówiennik
dyrektorka	dyrektor
ekshibicjonistka	ekshibicjonista
rozkazodawczyni	rozkazodawca
junaczka	junak
pruszkowianka	pruszkowianin
Gabonka	Gabończyk
demoralizatorka	demoralizator
dakarka	dakarczyk
zawodniczka	zawodnik
pacyfistka	pacyfista
podróżna	podróżny
propagatorka	propagator
laborantka	laborant
rzgowianka	rzgowianin
ajentka	ajent
gałganica	gałgan
Majanka	Maj
Sabinka	Sabińczyk
agnatka	agnat
nudystka	nudysta
pyszniczanka	pyszniczanin
opolanka	opolanin
furiatka	furiat
chopinistka	chopinista
bananówa	banan
wykładowczyni	wykładowca
pacholica	pachołek
mariawitka	mariawita
początkująca	początkujący
Azerbejdżanka	Azerbejdżanin
doradczyni	doradca
eurorealistka	eurorealista
Uzbeczka	Uzbek
kursistka	kursista
jeleniogórzanka	jeleniogórzanin
bullterierka	bullterier
prawoznawczyni	prawoznawca
dalmatynka	dalmatyńczyk
przygodziczanka	przygodziczanin
kuchmistrzyni	kuchmistrz
druciarka	druciarz
specjalizantka	specjalizant
ekspresjonistka	ekspresjonista
Samoanka	Samoańczyk
syfilityczka	syfilityk
indywidualistka	indywidualista
fetyszystka	fetyszysta
neapolitanka	neapolitańczyk
Spiszaczka	Spiszak
nowobogacka	nowobogacki
reżimówka	reżimowiec
meteoropatka	meteoropata
kraulistka	kraulista
łosica	łoś
cytrzystka	cytrzysta
sygnatariuszka	sygnatariusz
chemiczka	chemik
apologetka	apologetyk
darwinistka	darwinista
przeciwniczka	przeciwnik
Białorusinka	Białorusin
magnetyzerka	magnetyzer
Belgijka	Belg
kędzierzynianka	kędzierzynianin
szczurzyca	szczur
facetka	facet
kinomaniaczka	kinomaniak
poddana	poddany
łyżwiarka	łyżwiarz
prawodawczyni	prawodawca
Turczynka	Turek
zabierzowianka	zabierzowianin
pensjonariuszka	pensjonariusz
ekspartnerka	ekspartner
hrabianka	hrabia
sztutowianka	sztutowianin
psotnica	psotnik
gówniara	gówniarz
kramarka	kramarz
nestorka	nestor
robotnica	robotnik
wydawczyni	wydawca
przodownica pracy	przodownik pracy
cyniczka	cynik
waltornistka	waltornista
sklerotyczka	sklerotyk
magazynierka	magazynier
rajzerka	rajzer
oportunistka	oportunista
czarnucha	czarnuch
włamywaczka	włamywacz
barmanka	barman
wapniaczka	wapniak
śpiąca	śpiący
inwestorka	inwestor
Hellenka	Hellen
osiemdziesięciolatka	osiemdziesięciolatek
żywicielka	żywiciel
ciapata	ciapaty
meliniarka	meliniarz
Sundajka	Sundajczyk
kamedułka	kameduła
klasyczka	klasyk
Bretonka	Bretończyk
bukinistka	bukinista
legitymistka	legitymista
fanka	fan
wróżycha	wróż
Chorwatka	Chorwat
kapłanka	kapłan
Fenicjanka	Fenicjanin
szatynka	szatyn
Czarnogórka	Czarnogórzec
husytka	husyta
współpracownica	współpracownik
bluesmanka	bluesman
slalomistka	slalomista
pani	pan
piosenkarka	piosenkarz
Nepalka	Nepalczyk
dezerterka	dezerter
górniczka	górnik
Austryjaczka	Austryjak
ósmoklasistka	ósmoklasista
prohibicjonistka	prohibicjonista
bajonka	bajończyk
wytwornisia	wytworniś
deputantka	deputat
Ślunzaczka	Ślunzak
szubinianka	szubinianin
zapowiadaczka	zapowiadacz
rzymianka	rzymianin
aresztowana	aresztowany
wycieczkowiczka	wycieczkowicz
Korsykanka	Korsykańczyk
będzinianka	będzinianin
altowiolistka	altowiolista
szaradzistka	szaradzista
sublokatorka	sublokator
filmolożka	filmolog
załogantka	załogant
baletmistrzyni	baletmistrz
pretendentka	pretendent
starokatoliczka	starokatolik
bogini	bóg
teletypistka	teletypista
interesantka	interesant
kajakarka	kajakarz
bernenka	berneńczyk
mocodawczyni	mocodawca
kompanka	kompan
multimiliarderka	multimiliarder
impertynentka	impertynent
ekstrawertyczka	ekstrawertyk
ortoptystka	ortoptysta
ortorektyczka	ortorektyk
współzałożycielka	współzałożyciel
lamparcica	lampart
pięknisia	piękniś
Ormianka	Ormianin
Czeremiska	Czeremis
olimpijka	olimpijczyk
modniarka	modniarz
opatka	opat
poganka	poganin
uwięziona	uwięziony
mediewistka	mediewista
wodzisławianka	wodzisławianin
zetempówka	zetempowiec
przejeżdżająca	przejeżdżający
zmienniczka	zmiennik
liverpoolka	liverpoolczyk
Bahamka	Bahamczyk
Jukagirka	Jukagir
birbantka	birbant
zarażona	zarażony
deprawatorka	deprawator
rozkosznica	rozkosznik
tłuścioszka	tłuścioch
kolorystka	kolorysta
brudaska	brudas
kantorka	kantor
szynkarka	szynkarz
pozwana	pozwany
baletnica	baletnik
dziennikarka	dziennikarz
skrupulatka	skrupulat
brukselka	brukselczyk
koleżanka	kolega
borsuczyca	borsuk
współmałżonka	współmałżonek
chorzowianka	chorzowianin
audytorka	audytor
sosnowiczanka	sosnowiczanin
akwaforcistka	akwaforcista
rezydentka	rezydent
fornalka	fornal
Aborygenka	Aborygen
pyskowiczanka	pyskowiczanin
frutarianka	frutarianin
Szwedka	Szwed
bobowianka	bobowianin
literaturoznawczyni	literaturoznawca
flagelantka	flagelant
ciechanowianka	ciechanowianin
Galicjanka	Galicjanin
gosprzydowianka	gosprzydowianin
ambasadorka	ambasador
budapesztenka	budapeszteńczyk
kumoszka	kumoter
szachrajka	szachraj
monarchistka	monarchista
oswobodzicielka	oswobodziciel
łańcucianka	łańcucianin
anabaptystka	anabaptysta
pieśniarka	pieśniarz
służąca	służący
nestorianka	nestorianin
bibliolożka	bibliolog
dżudoczka	dżudoka
bakteriolożka	bakteriolog
portrecistka	portrecista
myślicielka	myśliciel
dietetyczka	dietetyk
paralotniarka	paralotniarz
dzikuska	dzikus
kibicka	kibic
Laponka	Lapończyk
trzebinianka	trzebinianin
kara	kary
porządnisia	porządniś
wojowniczka	wojownik
Ślunzoczka	Ślunzok
tygrysica	tygrys
szerzycielka	szerzyciel
współwładczyni	współwładca
przybywająca	przybywający
edukatorka	edukator
Aszkenazyjka	Aszkenazyjczyk
konfirmantka	konfirmant
dypsomanka	dypsoman
euroentuzjastka	euroentuzjasta
gnębicielka	gnębiciel
królobójczyni	królobójca
prymistka	prymista
golkiperka	golkiper
wieśniaczka	wieśniak
ewangeliczka	ewangelik
kilkulatka	kilkulatek
tłumaczka	tłumacz
krwiodawczyni	krwiodawca
pilotka	pilot
wiceszefowa	wiceszef
lublinianka	lublinianin
wygodnicka	wygodnicki
Węgierka	Węgier
Normandka	Normandczyk
opozycjonistka	opozycjonista
Tuwinka	Tuwiniec
suwałczanka	suwałczanin
gorzyczanka	gorzyczanin
prześmiewczyni	prześmiewca
doktorantka	doktorant
pallotynka	pallotyn
podopieczna	podopieczny
impresjonistka	impresjonista
traperka	traper
Pomorzanka	Pomorzanin
gastarbeiterka	gastarbeiter
trzecioklasistka	trzecioklasista
podróżniczka	podróżnik
filozofka	filozof
frajerka	frajer
turczanka	turczanin
tancerka	tancerz
astrolożka	astrolog
Uzbijka	Uzbek
współpasażerka	współpasażer
Seszelka	Seszelczyk
referentka	referent
czyściocha	czyścioch
Hawajka	Hawajczyk
dealerka	dealer
Karaimka	Karaim
amerykanistka	amerykanista
jaroszka	jarosz
bartoszyczanka	bartoszyczanin
hodowczyni	hodowca
złotniczka	złotnik
transwestytka	transwestyta
krzanowiczanka	krzanowiczanin
tryumfatorka	tryumfator
internistka	internista
belgradka	belgradczyk
recydywistka	recydywista
Wietnamka	Wietnamczyk
inteligentka	inteligent
Alzatka	Alzatczyk
Bhutanka	Bhutańczyk
nacjonalistka	nacjonalista
Bermudka	Bermudczyk
piekarka	piekarz
zegarmistrzyni	zegarmistrz
respondentka	respondent
suplikantka	suplikant
gimnastyczka	gimnastyk
skierniewiczanka	skierniewiczanin
seminarzystka	seminarzysta
izraelitka	izraelita
radzionkowianka	radzionkowianin
objawicielka	objawiciel
lotniczka	lotnik
baloniarka	baloniarz
szwaczka	szwacz
włoszakowiczanka	włoszakowiczanin
triathlonistka	triathlonista
korektorka	korektor
pasjonatka	pasjonat
najemczyni	najemca
uzdrowicielka	uzdrowiciel
pobożnisia	pobożniś
kompozytorka	kompozytor
dżinistka	dżinista
straganówka	straganowiec
plantatorka	plantator
żyrardowianka	żyrardowianin
wampirzyca	wampir
hufcowa	hufcowy
chorąża	chorąży
strzelczyni	strzelec
biłgorajka	biłgorajczyk
biometeorolożka	biometeorolog
ekumenistka	ekumenista
Czuwaszka	Czuwasz
intrygantka	intrygant
Sardynka	Sardyńczyk
dżudoczka	dżudok
harcmistrzyni	harcmistrz
publicystka	publicysta
Mołdawianka	Mołdawianin
oblatka	oblat
ceramiczka	ceramik
koicielka	koiciel
metodyczka	metodyk
gościówa	gość
semiwegetarianka	semiwegetarianin
dostojniczka	dostojnik
awangardzistka	awangardzista
obrończyni	obrońca
pasłęczanka	pasłęczanin
kaskaderka	kaskader
poprzedniczka	poprzednik
konceptualistka	konceptualista
łowczyni	łowca
pasażerka	pasażer
charcica	chart
kombatantka	kombatant
kicia	kiciuś
ryzykantka	ryzykant
piotrkowianka	piotrkowianin
zainteresowana	zainteresowany
posługaczka	posługacz
projektantka	projektant
prześladowczyni	prześladowca
wystawczyni	wystawca
felczerka	felczer
komorniczka	komornik
artystka	artysta
Saudyjka	Saudyjczyk
siwa	siwy
szamanka	szaman
chłopka	chłop
czcicielka	czciciel
nowelizatorka	nowelizator
przejezdna	przejezdny
składaczka	składacz
paralityczka	paralityk
zaklinaczka	zaklinacz
anglistka	anglista
Lankijka	Lankijczyk
Tunezyjka	Tunezyjczyk
norbertanka	norbertanin
zauszniczka	zausznik
podejrzana	podejrzany
stenotypistka	stenotypista
kaliszanka	kaliszanin
choreografka	choreograf
pomocnica	pomocnik
dypsomaniaczka	dypsomaniak
biegła sądowa	biegły sądowy
Filipinka	Filipińczyk
tancmistrzyni	tancmistrz
lubelaczka	lubelak
przedstawicielka	przedstawiciel
skarbniczka	skarbnik
biuralistka	biuralista
dyktatorka	dyktator
bezwstydnica	bezwstydnik
monologistka	monologista
wyznawczyni	wyznawca
kocica	kot
plażowiczka	plażowicz
cymbalistka	cymbalista
sługa Boża	Sługa Boży
blagierka	blagier
ekolożka	ekolog
imigrantka	imigrant
bonapartystka	bonapartysta
somnambuliczka	somnambulik
autorka	autor
mleczarka	mleczarz
wygnanka	wygnaniec
kognatka	kognat
żubrzyca	żubr
nihilistka	nihilista
neofilolożka	neofilolog
unihokeistka	unihokeista
konsjerżka	konsjerż
brzydula	brzydal
Kornijka	Kornijczyk
bazylejka	bazylejczyk
pasterka	pasterz
kołchoźnica	kołchoźnik
sadystka	sadysta
folksdojczka	folksdojcz
dróżniczka	dróżnik
forowiczka	forowicz
zajęczyca	zając
samotnica	samotnik
duszniczanka	duszniczanin
głuszyczanka	głuszyczanin
cieciorka	ciecier
narkomanka	narkoman
święta	święty
kangurzyca	kangur
damascenka	damasceńczyk
hetmanka	hetman
kubistka	kubista
Bawarka	Bawarczyk
pokuśnica	pokuśnik
onanistka	onanista
seterka	seter
dorobkiewiczka	dorobkiewicz
burzycielka	burzyciel
beginka	begard
buszczanka	buszczanin
senatorka	senator
didżejka	didżej
apostatka	apostata
urzędniczka	urzędnik
bezbożnica	bezbożnik
policjantka	policjant
płotkarka	płotkarz
pielęgniarka	pielęgniarz
pracownica	pracownik
Angielka	Anglik
grzesznica	grzesznik
masonka	mason
była	były
bajkopisarka	bajkopisarz
biathlonistka	biathlonista
ełczanka	ełczanin
makowianka	makowianin
pływaczka	pływak
nędznica	nędznik
wyjadaczka	wyjadacz
Tunguzka	Tunguz
przyrodniczka	przyrodnik
narratorka	narrator
florystka	florysta
etnografka	etnograf
Kresowianka	Kresowianin
konsultantka	konsultant
rozpustnica	rozpustnik
karogniada	karogniady
komańczanka	komańczanin
konspiratorka	konspirator
ministerka	minister
bochnianka	bochnianin
waluciara	waluciarz
windykatorka	windykator
posłusznica	posłusznik
diabetyczka	diabetyk
bilardzistka	bilardzista
bytowianka	bytowianin
palaczka	palacz
suchotniczka	suchotnik
skarżąca	skarżący
Asturyjka	Asturyjczyk
zausznica	zausznik
gotka	got
mizantropka	mizantrop
budapesztanka	budapesztańczyk
Słowaczka	Słowak
kamratka	kamrat
łajdaczka	łajdak
kopaniczanka	kopaniczanin
Cypryjka	Cypryjczyk
interwenientka	interwenient
katatoniczka	katatonik
sprzątaczka	sprzątacz
antyrojalistka	antyrojalista
misjonarka	misjonarz
socjuszka	socjusz
żałobniczka	żałobnik
bankrutka	bankrut
bydgoszczanka	bydgoszczanin
poszukiwana	poszukiwany
sędzia	sędzia
freelancerka	freelancer
biatlonistka	biatlonista
koprzywniczanka	koprzywniczanin
Dżibutka	Dżibutczyk
rybniczanka	rybniczanin
prawosławna	prawosławny
hinduistka	hinduista
flegmatyczka	flegmatyk
kaletniczka	kaletnik
rajfurka	rajfur
akcydensistka	akcydensista
siostrzenica	siostrzeniec
adoratorka	adorator
aferzystka	aferzysta
krzykaczka	krzykacz
grawerka	grawer
larpowiczka	larpowicz
banderówka	banderowiec
żniwiarka	żniwiarz
terrarystka	terrarysta
Drzewianka	Drzewianin
sorabistka	sorabista
demokratka	demokrata
Chakaska	Chakas
woodstockowiczka	woodstockowicz
interpretatorka	interpretator
familiantka	familiant
probabilistka	probabilista
lwica salonowa	lew salonowy
Adygejka	Adygejczyk
madrytka	madrytczyk
wybawicielka	wybawiciel
meteopatka	meteopata
futurystka	futurysta
dyspozytorka	dyspozytor
nowosądeczanka	nowosądeczanin
wskrzesicielka	wskrzesiciel
naukowczyni	naukowiec
dwójkowiczka	dwójkowicz
protokolantka	protokolant
kudowianka	kudowianin
zmywaczka	zmywacz
pomylona	pomylony
mistyfikatorka	mistyfikator
szefowa	szef
budzicielka	budziciel
kochanka	kochanek
modelka	model
Antiguanka	Antiguańczyk
roznosicielka	roznosiciel
autystka	autysta
wieloboistka	wieloboista
reprezentantka	reprezentant
rakoniewiczanka	rakoniewiczanin
egotystka	egotysta
gliwiczanka	gliwiczanin
stenografka	stenograf
bliźniaczka	bliźniak
Turynka	Turyńczyk
egzekutorka	egzekutor
wiślanka	wiślanin
gęsiarka	gęsiarek
koniunkturalistka	koniunkturalista
hrabina	hrabia
półinteligentka	półinteligent
swojaczka	swojak
profesjonalistka	profesjonalista
tekstylna	tekstylny
protetyczka	protetyk
kumpela	kumpel
brodniczanka	brodniczanin
helsinka	helsińczyk
użytkowniczka	użytkownik
świniarka	świniarz
Dagestanka	Dagestańczyk
minimalistka	minimalista
tenisistka	tenisista
agrotechniczka	agrotechnik
wytwórczyni	wytwórca
bezdomna	bezdomny
muzyczka	muzyk
Wenezuelka	Wenezuelczyk
Nubijka	Nubijczyk
trynitarka	trynitarz
Madziarka	Madziar
kochaneczka	kochaneczek
Wilamowianka	Wilamowianin
eurosceptyczka	eurosceptyk
dwójara	dwójarz
posesjonatka	posesjonat
alterglobalistka	alterglobalista
nowa	nowy
Gwinejka	Gwinejczyk
Malijka	Malijczyk
solistka	solista
piesza	pieszy
wadowiczanka	wadowiczanin
moralizatorka	moralizator
zaklikowianka	zaklikowianin
scenarzystka	scenarzysta
młodziczka	młodzik
skrupulantka	skrupulant
antreprenerka	antreprener
bolimowianka	bolimowianin
atenka	ateńczyk
współwłaścicielka	współwłaściciel
małpiszonka	małpiszon
osiemnastolatka	osiemnastolatek
dyżurna ruchu	dyżurny ruchu
konserwatorka	konserwator
obca	obcy
Ewenka	Ewenk
ksenofilka	ksenofil
monogamistka	monogamista
Wielkopolanka	Wielkopolanin
szatniarka	szatniarz
projektodawczyni	projektodawca
Hiszpanka	Hiszpan
babiczanka	babiczanin
turzyca	tur
probantka	probant
inspiratorka	inspirator
nadzorczyni	nadzorca
demiseksualistka	demiseksualista
inicjatorka	inicjator
śpiewaczka	śpiewak
charyzmatyczka	charyzmatyk
triumfatorka	triumfator
służka	sługa
rygorystka	rygorysta
Beotka	Beota
menażerka	menażer
Nowa Ruska	Nowy Ruski
heretyczka	heretyk
hippiska	hippis
lisiczka	lisica
systematyczka	systematyk
chartka	chart
rekordzistka	rekordzista
czarownica	czarownik
szóstoklasistka	szóstoklasista
snowboardzistka	snowboardzista
indianistka	indianista
leszczynianka	leszczynianin
aforystka	aforysta
odbiorczyni	odbiorca
ałmaatka	ałmaatczyk
mormonka	mormon
historyczka	historyk
ochroniarka	ochroniarz
dizajnerka	dizajner
harfiarka	harfiarz
bizantynistka	bizantynista
pietrowiczanka	pietrowiczanin
pionierka	pionier
erotomanka	erotoman
korepetytorka	korepetytor
innowierczyni	innowierca
teściowa	teść
zabugolka	zabugol
pomywaczka	pomywacz
Komoryjka	Komoryjczyk
akompaniatorka	akompaniator
kłodniczanka	kłodniczanin
libiążanka	libiążanin
piątoklasistka	piątoklasista
drobnomieszczanka	drobnomieszczanin
sklepowa	sklepowy
hamburka	hamburczyk
hipokrytka	hipokryta
rysica	ryś
sanitariuszka	sanitariusz
pudliczka	pudel
gloryfikatorka	gloryfikator
bumelantka	bumelant
udawaczka	udawacz
promotorka	promotor
Gwatemalka	Gwatemalczyk
sutenerka	sutener
kalkulatorka	kalkulator
Inkaska	Inkas
poganiaczka	poganiacz
wywiadowczyni	wywiadowca
imitatorka	imitator
Pasztunka	Pasztun
wegetarianka	wegetarianin
powinowata	powinowaty
symulantka	symulant
domokrążczyni	domokrążca
rajczyni	rajca
Babiogórka	Babiogórzec
dokumentarzystka	dokumentarzysta
multimilionerka	multimilioner
Jawajka	Jawajczyk
bułgarystka	bułgarysta
Honduraska	Honduraszczyk
naturalistka	naturalista
poszukiwaczka	poszukiwacz
elfica	elf
obsesjonistka	obsesjonista
niewidoma	niewidomy
zmiennistka	zmiennista
wyrobnica	wyrobnik
fantastka	fantasta
Zapotekijka	Zapotekijczyk
Spartanka	Spartanin
managerka	manager
nieboraczka	nieborak
dyrygentka	dyrygent
gestykulatorka	gestykulator
augustowianka	augustowianin
hellenistka	hellenista
porządnicka	porządnicki
mantuanka	mantuańczyk
bełchatowianka	bełchatowianin
antyglobalistka	antyglobalista
melomanka	meloman
dendrolożka	dendrolog
deistka	deista
podrabiaczka	podrabiacz
ceglarka	ceglarz
rozmówczyni	rozmówca
jasnowidzka	jasnowidz
śpioszka	śpioch
sortowaczka	sortowacz
Zairka	Zairczyk
biwakowiczka	biwakowicz
sprinterka	sprinter
zakonnica	zakonnik
erkaemistka	erkaemista
Libanka	Libańczyk
terapeutka	terapeuta
nowelistka	nowelista
przewodniczka	przewodnik
armatorka	armator
docentka	docent
jeźdźczyni	jeździec
animalistka	animalista
brzuchomówczyni	brzuchomówca
kamieniczniczka	kamienicznik
członkini	członek
współzawodnica	współzawodnik
trapistka	trapista
alarmistka	alarmista
najemnica	najemnik
bibliomanka	biblioman
opluwaczka	opluwacz
chora	chory
okazicielka	okaziciel
dowódczyni	dowódca
wizjonerka	wizjoner
cwaniaczka	cwaniak
anglikanka	anglikanin
Fidżijka	Fidżijczyk
rumunka	rumun
terminatorka	terminator
pakowaczka	pakowacz
praprawnuczka	praprawnuk
mała	mały
ciapatka	ciapat
bratanka	bratanek
rysowniczka	rysownik
hobbystka	hobbysta
bufetowa	bufetowy
ironistka	ironista
krakowianka	krakowianin
pośrednica	pośrednik
Kamerunka	Kameruńczyk
Jamajka	Jamajczyk
paryżanka	paryżanin
scenografka	scenograf
komorniczanka	komorniczanin
fletnistka	fletnista
dysgraficzka	dysgrafik
carowa	car
Jordanka	Jordańczyk
chamka	cham
zbieraczka	zbieracz
domownica	domownik
dysertantka	dysertant
oleśniczanka	oleśniczanin
kolporterka	kolporter
bałwanica	bałwan
beduinka	beduin
zwyciężczyni	zwycięzca
rugbistka	rugbista
przedstawicielka handlowa	przedstawiciel handlowy
saksofonistka	saksofonista
Syryjka	Syryjczyk
solipsystka	solipsysta
zastępowa	zastępowy
sokistka	sokista
kolesiana	koleś
chasydka	chasyd
suflerka	sufler
aferałka	aferał
wychowanka	wychowanek
filipowianka	filipowianin
samolubka	samolub
bobsleistka	bobsleista
championka	champion
ekscentryczka	ekscentryk
prorokini	prorok
desperatka	desperat
częstochowianka	częstochowianin
Aszkenazka	Aszkenazyjczyk
demonka	demon
koncertantka	koncertant
łotrzyca	łotr
bywalczyni	bywalec
uniwersalistka	uniwersalista
masażystka	masażysta
Singapurka	Singapurczyk
laktoowowegetarianka	laktoowowegetarianin
pianistka	pianista
chełmnianka	chełmnianin
Grenadyjka	Grenadyjczyk
błonianka	błonianin
dyplomatka	dyplomata
współrodaczka	współrodak
auletka	auleta
marnotrawczyni	marnotrawca
wagarowiczka	wagarowicz
kolesiówa	koleś
telepatka	telepata
uzurpatorka	uzurpator
chrzestna	chrzestny
humorystka	humorysta
przewodnicząca	przewodniczący
lektorka	lektor
chora psychicznie	chory psychicznie
potrzebująca	potrzebujący
psorka	psor
Aramejka	Aramejczyk
rugbystka	rugbysta
błogosławiona	błogosławiony
monarchini	monarcha
moralistka	moralista
magistrantka	magistrant
Macedonka	Macedończyk
Peruwianka	Peruwianin
osadniczka	osadnik
szelmutka	szelma
tytanka	tytan
żabniczanka	żabniczanin
inspektorka	inspektor
zuchenka	zuch
karykaturzystka	karykaturzysta
samobójczyni	samobójca
mężyna	mąż
kasjerka	kasjer
kapucynka	kapucyn
Watykanka	Watykańczyk
bogatynianka	bogatynianin
pastuszka	pastuch
diuszesa	diuk
aliantka	aliant
cyganicha	cygan
mulica	muł
nieboszczka	nieboszczyk
skąpica	skąpiec
pisarka	pisarz
nabywczyni	nabywca
biznesmenka	biznesmen
lingwistka	lingwista
krewniaczka	krewniak
prawaczka	prawak
megalomanka	megaloman
jedynaczka	jedynak
wyzyskiwaczka	wyzyskiwacz
dekabrystka	dekabrysta
koziarka	koziarz
dwulatka	dwulatek
rowerzystka	rowerzysta
skawinianka	skawinianin
burżujka	burżuj
zakupoholiczka	zakupoholik
brzeżanka	brzeżanin
rezerwistka	rezerwista
masochistka	masochista
dywaniarka	dywaniarz
egalitarystka	egalitarysta
żydówka	żyd
orantka	orant
dogmatyczka	dogmatyk
absolwentka	absolwent
bocianica	bocian
Chilijka	Chilijczyk
despotka	despota
kierowniczka	kierownik
demonstratorka	demonstrator
buddystka	buddysta
gapowiczka	gapowicz
posiadaczka	posiadacz
poetessa	poeta
wyrazicielka	wyraziciel
proletariuszka	proletariusz
malkontentka	malkontent
Ghanijka	Ghańczyk
kołtunka	kołtun
spryciara	spryciarz
kolbuszowianka	kolbuszowianin
lodziarka	lodziarz
badaczka	badacz
kryminalistka	kryminalista
nieprzyjaciółka	nieprzyjaciel
Jankeska	Jankes
Irlandka	Irlandczyk
striptizerka	striptizer
albinoska	albinos
równolatka	równolatek
krawcowa	krawiec
piromanka	piroman
berlinka	berlińczyk
celniczka	celnik
saneczkarka	saneczkarz
motorowerzystka	motorowerzysta
kuma	kum
Islandka	Islandczyk
ceperka	ceper
krakuska	krakus
pozerka	pozer
muzułmanka	muzułmanin
służbistka	służbista
motornicza	motorniczy
heteroseksualistka	heteroseksualista
włókniarka	włókniarz
chałupnica	chałupnik
aktywistka	aktywista
unionistka	unionista
dramatopisarka	dramatopisarz
Helwetka	Helweta
Malawijka	Malawijczyk
kadrowiczka	kadrowicz
Iranka	Irańczyk
neonazistka	neonazista
mecenaska	mecenas
jaworznianka	jaworznianin
szablistka	szablista
bejsbolistka	bejsbolista
gorylica	goryl
mediolanka	mediolańczyk
Paragwajka	Paragwajczyk
sintoistka	sintoista
prelegentka	prelegent
reżyserka	reżyser
Dolnoślązaczka	Dolnoślązak
komunistka	komunista
mandolinistka	mandolinista
wicemistrzyni	wicemistrz
stróżka	stróż
Teksanka	Teksańczyk
Galisyjka	Galisyjczyk
niewolniczka	niewolnik
cyklistka	cyklista
narciarka dowolna	narciarz dowolny
sztubaczka	sztubak
prawnuk	prawnuczka
europarlamentarzystka	europarlamentarzysta
szajbuska	szajbus
współuczestniczka	współuczestnik
Sotyjka	Sotyjczyk
protektorka	protektor
anarchistka	anarchista
paskudnica	paskudnik
gorzelniczka	gorzelnik
epileptyczka	epileptyk
szowinistka	szowinista
behawiorystka	behawiorysta
arianka	arianin
deponentka	deponent
boginka	bożek
żebraczka	żebrak
biofizyczka	biofizyk
finansistka	finansista
kolejarka	kolejarz
radkowianka	radkowianin
rudzianka	rudzianin
rzeczniczka prasowa	rzecznik prasowy
rawianka	rawianin
brygadierka	brygadier
czempionka	czempion
kleptomanka	kleptoman
rudnianka	rudnianin
andorka	andorczyk
Afroamerykanka	Afroamerykanin
literniczka	liternik
proepidemiczka	proepidemik
potwora	potwór
ogrodniczka	ogrodnik
Boliwijka	Boliwijczyk
rzeszowianka	rzeszowianin
italianistka	italianista
ojcobójczyni	ojcobójca
koleżanka po fachu	kolega po fachu
koszalinianka	koszalinianin
Marsjanka	Marsjanin
Kaszubka	Kaszub
młynarka	młynarz
kornecistka	kornecista
animatorka	animator
biesiadniczka	biesiadnik
filutka	filut
krowiarka	krowiarz
Tongijka	Tongijczyk
baranowianka	baranowianin
śmierdziucha	śmierdziuch
sceptyczka	sceptyk
wicedyrektorka	wicedyrektor
kąkolewianka	kąkolewianin
varsavianistka	varsavianista
językoznawczyni	językoznawca
Huronka	Huron
felietonistka	felietonista
dębiczanka	dębiczanin
tańcownica	tańcownik
meksykanka	meksykanin
wspólniczka	wspólnik
Kuszytka	Kuszyta
imienniczka	imiennik
biolożka	biolog
heteryczka	heteryk
Bizantyjka	Bizantyjczyk
Litwinka	Litwin
katorżniczka	katorżnik
altruistka	altruista
wasalka	wasal
bezrobotna	bezrobotny
partykularystka	partykularysta
koszykarka	koszykarz
mistrzyni	mistrz
Ruandyjka	Ruandyjczyk
komiczka	komik
kustoszka	kustosz
Słowenka	Słoweniec
cudzołożnica	cudzołożnik
Aryjka	Aryjczyk
wrotkarka	wrotkarz
Austriaczka	Austriak
Katarka	Katarczyk
mandatariuszka	mandatariusz
Kirgizka	Kirgiz
mopsica	mops
Persjanka	Pers
romanistka	romanista
współregentka	współregent
atomistka	atomista
niedźwiedzica	niedźwiedź
znawczyni	znawca
równiaczka	równiak
Irakijka	Irakijczyk
bychawianka	bychawianin
tyranka	tyran
kijowianka	kijowianin
oratorka	orator
sędzina	sędzia
antyfeministka	antyfeminista
wartowniczka	wartownik
elegantka	elegant
Kuwejtka	Kuwejtczyk
Czarnogórzanka	Czarnogórzec
Bahrajnka	Bahrajńczyk
graficzka	grafik
organizatorka	organizator
skrzypaczka	skrzypek
sybarytka	sybaryta
Czirokezka	Czirokez
winowajczyni	winowajca
Kurdyjka	Kurd
współbiesiadniczka	współbiesiadnik
wielunianka	wielunianin
aspirantka	aspirant
gorliczanka	gorliczanin
lichwiarka	lichwiarz
Abisynka	Abisyńczyk
weterynarka	weterynarz
niewdzięcznica	niewdzięcznik
jejmość	jegomość
malwersantka	malwersant
Laosyjka	Laosyjczyk
lyonka	lyończyk
fotografka	fotograf
poliglotka	poliglota
wybranka	wybranek
kłamczucha	kłamczuch
przeorysza	przeor
naczelna	naczelny
literatka	literat
laureatka	laureat
Papuaska	Papuas
solenizantka	solenizant
wspominkarka	wspominkarz
prószkowianka	prószkowianin
owolaktarianka	owolaktarianin
Rusinka	Rusin
kretynka	kretyn
nuworyszka	nuworysz
reporterka	reporter
jastrowianka	jastrowianin
smarkata	smarkacz
aplikantka	aplikant
radna	radny
bułana	bułany
dentystka	dentysta
urlopowiczka	urlopowicz
smerfetka	smerf
Japonka	Japończyk
statystka	statysta
morderczyni	morderca
klubowiczka	klubowicz
radykalistka	radykalista
niepołomiczanka	niepołomiczanin
Zuluska	Zulus
rybiarka	rybiarz
utylitarystka	utylitarysta
barcelonka	barcelończyk
eksploatatorka	eksploatator
upiornica	upiór
Norweżka	Norweg
carewna	carewicz
świętoszka	świętoszek
karmelitanka	karmelita
fizjoterapeutka	fizjoterapeuta
bułanka	bułanek
brygadzistka	brygadzista
kotka	kot
aranżerka	aranżer
dziadówka	dziad
ciastkarka	ciastkarz
autyczka	autyk
Pendżabka	Pendżab
streetworkerka	streetworker
wrona	wrony
fundatorka	fundator
jamniczka	jamnik
hipnotyzerka	hipnotyzer
kuglarka	kuglarz
couchsurferka	couchsurfer
instagramerka	instagramer
komentatorka	komentator
słomiana wdowa	słomiany wdowiec
żywczanka	żywczanin
Ewenkijka	Ewenk
sprawczyni	sprawca
kreatorka	kreator
zapaśniczka	zapaśnik
spirytualistka	spirytualista
wariatka	wariat
dekoratorka wnętrz	dekorator wnętrz
jogini	jogin
melancholiczka	melancholik
Bułgarka	Bułgar
słupszczanka	słupszczanin
imperatorowa	imperator
Kubanka	Kubańczyk
franciszkanka	franciszkanin
akcjonariuszka	akcjonariusz
Amerykanka	Amerykanin
swatowa	swat
luzaczka	luzak
koneserka	koneser
drużka	drużba
dublerka	dubler
kwestarka	kwestarz
koteczka	koteczek
gilowiczanka	gilowiczanin
kosmitka	kosmita
sławkowianka	sławkowianin
służebniczka	służebnik
hultajka	hultaj
gołąbka	gołąb
bat micwa	bar micwa
cyganeczka	cyganek
judoczka	judok
radomianka	radomianin
wilamowiczanka	wilamowiczanin
wartkowiczanka	wartkowiczanin
akademiczka	akademik
półfinalistka	półfinalista
autobiografka	autobiograf
admiratorka	admirator
trójboistka	trójboista
zawistnica	zawistnik
Palestynka	Palestyńczyk
mizogamistka	mizogamista
Omanka	Omańczyk
kundmanka	kundman
Niderlandka	Niderlandczyk
Skandynawka	Skandynaw
egzystencjalistka	egzystencjalista
dwunastolatka	dwunastolatek
ćwierćinteligentka	ćwierćinteligent
ważniaczka	ważniak
dewiatka	dewiat
wszetecznica	wszetecznik
jezuitka	jezuita
królowa	król
biseksualistka	biseksualista
licytatorka	licytator
Lakonka	Lakończyk
spanielka	spaniel
prudniczanka	prudniczanin
szefowa kuchni	szef kuchni
Rwandyjka	Rwandyjczyk
patronka	patron
Kartaginka	Kartagińczyk
świętokradczyni	świętokradca
nowotarżanka	nowotarżanin
cyzelatorka	cyzelator
bałwochwalczyni	bałwochwalca
oślica	osioł
spacerowiczka	spacerowicz
Ugandyjka	Ugandyjczyk
Dunka	Duńczyk
antyterrorystka	antyterrorysta
czwartoklasistka	czwartoklasista
harcerka	harcerz
wędkarka	wędkarz
konduktorka	konduktor
dydaktyczka	dydaktyk
gostyninianka	gostyninianin
młódka	młodzian
Banglijka	Banglijczyk
pijana	pijany
teatromanka	teatroman
trockistka	trockista
zwiastunka	zwiastun
następczyni	następca
kolędniczka	kolędnik
stróżówka	stróż
ankietowana	ankietowany
amsterdamka	amsterdamczyk
stulatka	stulatek
łakomczucha	łakomczuch
tajniaczka	tajniak
Fryzyjka	Fryz
pustelnica	pustelnik
towarzyszka	towarzysz
podpalaczka	podpalacz
papistka	papista
maniaczka	maniak
pozorantka	pozorant
depozytariuszka	depozytariusz
biologica	biolog
gorzowianka	gorzowianin
Podhalanka	Podhalanin
chuliganka	chuligan
Jakutka	Jakut
antykwariuszka	antykwariusz
kurierka	kurier
wikipedystka	wikipedysta
faszystka	faszysta
nastolatka	nastolatek
zbrodniarka	zbrodniarz
socjopatka	socjopata
altystka	altysta
czelistka	czelista
funkcjonariuszka	funkcjonariusz
dyplomantka	dyplomant
piwniczanka	piwniczanin
nabożnisia	nabożniś
Hercegowinka	Hercegowińczyk
narzeczona	narzeczony
metodystka	metodysta
kujonka	kujon
komornica	komornik
starucha	staruch
Francuzka	Francuz
krewna	krewny
bejrutka	bejrutczyk
ekspedientka	ekspedient
Nowa Rosjanka	Nowy Rosjanin
współwięźniarka	współwięzień
bibliotekoznawczyni	bibliotekoznawca
świadkowa	świadek
pięćdziesięciolatka	pięćdziesięciolatek
mataczka	matacz
blokierka	blokier
Mikronezyjka	Mikronezyjczyk
archiwistka	archiwista
Tahitanka	Tahitańczyk
konstruktorka	konstruktor
psychoterapeutka	psychoterapeuta
biblistka	biblista
piwoszka	piwosz
imprezowiczka	imprezowicz
bieczanka	bieczanin
Żydówka	Żyd
jejmościanka	jegomość
Żmujdzinka	Żmujdzin
malanowianka	malanowianin
gostynianka	gostynianin
Egipcjanka	Egipcjanin
petentka	petent
antykomunistka	antykomunista
astronomka	astronom
mińszczanka	mińszczanin
wirtuozka	wirtuoz
ewangelizatorka	ewangelizator
dobrodziejka	dobrodziej
odtwórczyni	odtwórca
spryciula	spryciula
świebodziczanka	świebodziczanin
zatrudniona	zatrudniony
szpanerka	szpaner
fighterka	fighter
ekranizatorka	ekranizator
antysemitka	antysemita
polonistka	polonista
lubieżnica	lubieżnik
Gambijka	Gambijczyk
notariuszka	notariusz
tokijka	tokijczyk
hipochondryczka	hipochondryk
indyczka	indyk
Nigerka	Nigerczyk
zdobywczyni	zdobywca
konkubina	konkubin
Gruzinka	Gruzin
prezenterka	prezenter
bioenergoterapeutka	bioenergoterapeuta
lizbonka	lizbończyk
potomkini	potomek
freeganka	freeganin
introligatorka	introligator
oprowadzaczka	oprowadzacz
krzczonowianka	krzczonowianin
lekomanka	lekoman
werblistka	werblista
emisariuszka	emisariusz
kapryśnica	kapryśnik
zgierzanka	zgierzanin
nikczemnica	nikczemnik
Wołynianka	Wołynianin
przechlewianka	przechlewianin
jaworzanka	jaworzanin
rozdawczyni	rozdawca
kontynuatorka	kontynuator
księżna	książę
oskarżycielka posiłkowa	oskarżyciel posiłkowy
rewidentka	rewident
Indonezyjka	Indonezyjczyk
bajarka	bajarz
uczestniczka	uczestnik
markowianka	markowianin
współtwórczyni	współtwórca
karciara	karciarz
Libijka	Libijczyk
Luksemburka	Luksemburczyk
brzezinianka	brzezinianin
pejzażystka	pejzażysta
farmaceutka	farmaceuta
Czeczenka	Czeczen
satanistka	satanista
aptekarka	aptekarz
szczęściara	szczęściarz
czatowniczka	czatownik
jastrzębianka	jastrzębianin
rekwizytorka	rekwizytor
Kazaszka	Kazach
pełnomocniczka	pełnomocnik
poznanianka	poznanianin
chamówa	cham
Słowinka	Słowiniec
magnatka	magnat
garbuska	garbus
belferka	belfer
gwarantka	gwarant
doboszka	dobosz
współpracowniczka	współpracownik
dzierżawczyni	dzierżawca
sąsiadka	sąsiad
bursztynniczka	bursztynnik
penitentka	penitent
stręczycielka	stręczyciel
Bośniaczka	Bośniak
przewodnica	przewodnik
gdańszczanka	gdańszczanin
manipulantka	manipulant
bojówkarka	bojówkarz
humanistka	humanista
złotowianka	złotowianin
stewardesa	steward
łyżwiarka szybka	łyżwiarz szybki
przełożona	przełożony
kuplerka	kupler
puzonistka	puzonista
Lechitka	Lechita
koregentka	koregent
Kampuczanka	Kampuczanin
Hebrajka	Hebrajczyk
autochtonka	autochton
barcinianka	barcinianin
Pakistanka	Pakistańczyk
chytruska	chytrus
Birmanka	Birmańczyk
kunktatorka	kunktator
defetystka	defetysta
miłośniczka	miłośnik
prezydentka	prezydent
Toskanka	Toskańczyk
blondynka	blondyn
schizofreniczka	schizofrenik
Senegalka	Senegalczyk
adherentka	adherent
filolożka	filolog
stelmaszka	stelmach
uwodzicielka	uwodziciel
spekulantka	spekulant
obłudnica	obłudnik
maruderka	maruder
wrocławianka	wrocławianin
badmintonistka	badmintonista
plastyczka	plastyk
jubilerka	jubiler
wazeliniara	wazeliniarz
racjonalizatorka	racjonalizator
żartownisia	żartowniś
Frygijka	Fryg
łachmaniara	łachmaniarz
heroska	heros
rzymskokatoliczka	rzymskokatolik
Karaczajka	Karaczaj
paranoiczka	paranoik
shintoistka	shintoista
Kostarykanka	Kostarykanin
głogowianka	głogowianin
złośnica	złośnik
posłannica	posłannik
uciekinierka	uciekinier
krakauerka	krakauer
figlarka	figlarz
kameralistka	kameralista
miejscowa	miejscowy
praderka	praderek
purytanka	purytanin
Etiopka	Etiopczyk
prawniczka	prawnik
Ekwadorka	Ekwadorczyk
żabkarka	żabkarz
Monakijka	Monakijczyk
doktrynerka	doktryner
Nigeryjka	Nigeryjczyk
hobbistka	hobbista
wągrowiczanka	wągrowiczanin
szachistka	szachista
wykonawczyni	wykonawca
krośniczanka	krośniczanin
zazdrośnica	zazdrośnik
wilnianka	wilnianin
dysydentka	dysydent
wysłanniczka	wysłannik
mitomanka	mitoman
melodeklamatorka	melodeklamator
obieżyświatka	obieżyświat
Tasmanka	Tasmańczyk
rybaczka	rybak
sanoczanka	sanoczanin
Salwadorka	Salwadorczyk
czchowianka	czchowianin
tułaczka	tułacz
szczyglica	szczygieł
Łemkynia	Łemko
Lesbijka	Lesbijczyk
starosądeczanka	starosądeczanin
zgrywuska	zgrywus
Sowietka	Sowiet
marsylka	marsylczyk
himalaistka	himalaista
Prusaczka	Prusak
Azjatka	Azjata
adwentystka	adwentysta
falangistka	falangista
biografka	biograf
edytorka	edytor
strażniczka	strażnik
Galijka	Gal
piłkarka	piłkarz
brzeszczanka	brzeszczanin
fryzjerka	fryzjer
wiceprezeska	wiceprezes
małolata	małolat
alpinistka	alpinista
trzpiotka	trzpiot
pięciolatka	pięciolatek
rekrutka	rekrut
spadkodawczyni	spadkodawca
siatkarka	siatkarz
dworzanka	dworzanin
handlarka	handlarz
kostiumerka	kostiumer
neurasteniczka	neurastenik
sensatka	sensat
alpejka	alpejczyk
Karaitka	Karaita
znajoma	znajomy
laburzystka	laburzysta
konferansjerka	konferansjer
doliniarka	doliniarz
szylkretka	szylkret
Haitanka	Haitańczyk
zaproszona	zaproszony
oazowiczka	oazowicz
agitatorka	agitator
Dalmatka	Dalmata
lokatorka	lokator
bibułkarka	bibułkarz
Kastylijka	Kastylijczyk
keyboardzistka	keyboardzista
Nowojorczanka	Nowojorczyk
znajoma z widzenia	znajomy z widzenia
maronitka	maronita
wizażystka	wizażysta
pryncypialistka	pryncypialista
łuczniczka	łucznik
kielczanka	kielczanin
Maoryska	Maorys
białogardzianka	białogardzianin
Meksykanka	Meksykanin
rewolucjonistka	rewolucjonista
przeciszowianka	przeciszowianin
marzycielka	marzyciel
afrykanistka	afrykanista
dyslektyczka	dyslektyk
kodyfikatorka	kodyfikator
arcymistrzyni	arcymistrz
źrebica	źrebiec
kuplecistka	kuplecista
profanatorka	profanator
kwiaciarka	kwiaciarz
rekistka	rekista
Katalonka	Katalończyk
albertynka	albertyn
gimnazjalistka	gimnazjalista
socjaldemokratka	socjaldemokrata
profanka	profan
goleniowianka	goleniowianin
sekserka	sekser
archeolożka	archeolog
kontrkandydatka	kontrkandydat
skandalistka	skandalista
wielbicielka	wielbiciel
fizykoterapeutka	fizykoterapeuta
pięcioboistka	pięcioboista
tercjarka	tercjarz
akolitka	akolita
recepcjonistka	recepcjonista
dwudziestolatka	dwudziestolatek
antybohaterka	antybohater
balowiczka	balowicz
psycholożka	psycholog
medyczka	medyk
sybiraczka	sybirak
gazeciarka	gazeciarz
koluszkowianka	koluszkowianin
jurorka	juror
lunatyczka	lunatyk
bolesławczanka	bolesławczanin
eks-komunistka	eks-komunista
księgoznawczyni	księgoznawca
reportażystka	reportażysta
Trojanka	Trojanin
astronautka	astronauta
ostrowczanka	ostrowczanin
Adżarka	Adżar
spartanka	spartanin
wieliczanka	wieliczanin
wokalistka	wokalista
denatka	denat
Suwałczanka	Suwałczanin
penitencjarystka	penitencjarysta
naciągaczka	naciągacz
dromaderka	dromader
Togijka	Togijczyk
orientalistka	orientalista
cyzelerka	cyzeler
heroinistka	heroinista
współorganizatorka	współorganizator
tkaczka	tkacz
gdynianka	gdynianin
homoseksualistka	homoseksualista
tępicielka	tępiciel
detalistka	detalista
Maryjka	Maryjczyk
birofilistka	birofilista
taterniczka	taternik
rusofilka	rusofil
chirolożka	chirolog
pracoholiczka	pracoholik
speakerka	speaker
talmudystka	talmudysta
malarka	malarz
leserka	leser
łowiczanka	łowiczanin
oświęcimianka	oświęcimianin
opowiadaczka	opowiadacz
chodzieżanka	chodzieżanin
Lesotyjka	Lesotyjczyk
pedikiurzystka	pedikiurzysta
zielarka	zielarz
anemiczka	anemik
Malgaszka	Malgasz
głuszka	głuszec
bernardynka	bernardyn
kanarzyca	kanarek
beletrystka	beletrysta
instygatorka	instygator
sportsmenka	sportsmen
kidnaperka	kidnaper
folblutka	folblut
Izraelka	Izraelczyk
komendantka	komendant
Ukrainka	Ukrainiec
kolaborantka	kolaborant
piliczanka	piliczanin
wieszczka	wieszczek
akwarelistka	akwarelista
szympansica	szympans
defraudantka	defraudant
góralka	góral
Kalifornijka	Kalifornijczyk
diablica	diabeł
stwórczyni	stwórca
maksymalistka	maksymalista
negacjonistka	negacjonista
konkurentka	konkurent
akwanautka	akwanauta
mediatorka	mediator
sklepikarka	sklepikarz
półanalfabetka	półanalfabeta
partyzantka	partyzant
forumowiczka	forumowicz
kwidzynianka	kwidzynianin
youtuberka	youtuber
dąbrowianka	dąbrowianin
sarmatka	sarmata
Baskijka	Bask
bierunianka	bierunianin
narciarka	narciarz
fakturzystka	fakturzysta
wodzirejka	wodzirej
ortoptyczka	ortoptyk
komediantka	komediant
okulistka	okulista
Tanzanka	Tanzańczyk
eksporterka	eksporter
konwertytka	konwertyta
chwalczyni	chwalca
drogistka	drogista
sulechowianka	sulechowianin
karczmarka	karczmarz
producentka	producent
współzawodniczka	współzawodnik
taoistka	taoista
rasistka	rasista
Udmurtyjka	Udmurta
pracownica biurowa	pracownik biurowy
czternastolatka	czternastolatek
anestezjolożka	anestezjolog
rozrabiara	rozrabiaka
adaptatorka	adaptator
mistyczka	mistyk
karlica	karzeł
licealistka	licealista
gorszycielka	gorszyciel
Berberyjka	Berber
żółwica	żółw
kokilarka	kokilarz
Tatarka	Tatar
Małorusinka	Małorusin
karierowiczka	karierowicz
Tajka	Taj
danserka	danser
materialistka	materialista
maoistka	maoista
kelnerka	kelner
bieliźniarka	bieliźniarz
Czejenka	Czejen
Mongołka	Mongoł
humanizatorka	humanizator
socjalistka	socjalista
deterministka	determinista
Tamilka	Tamil
lotniarka	lotniarz
Kampanka	Kampańczyk
wenecjanka	wenecjanin
Marokanka	Marokańczyk
antropolożka	antropolog
intelektualistka	intelektualista
zabłocianka	zabłocianin
biorczyni	biorca
cysterka	cysters
furtianka	furtian
stypendystka	stypendysta
rencistka	rencista
Tajwanka	Tajwańczyk
luterka	luteranin
kontrahentka	kontrahent
uczennica	uczeń
Szwajcarka	Szwajcar
znajdka	znajdek
Suazyjka	Suazyjczyk
świeradowianka	świeradowianin
indolożka	indolog
multiinstrumentalistka	multiinstrumentalista
abstynentka	abstynent
hospitantka	hospitant
przyjaciółka	przyjaciel
psychopatka	psychopata
salezjanka	salezjanin
Maltanka	Maltańczyk
dysponentka	dysponent
operatorka	operator
annalistka	annalista
przemyślanka	przemyślanin
geografka	geograf
bielszczanka	bielszczanin
cinkciara	cinkciarz
współwyznawczyni	współwyznawca
patriotka	patriota
kontrabandzistka	kontrabandzista
Pensylwanka	Pensylwańczyk
Beninka	Benińczyk
Rodezyjka	Rodezyjczyk
Małorosjanka	Małorosjanin
pragmatyczka	pragmatyk
przybyszka	przybysz
Jugosłowianka	Jugosłowianin
astrofizyczka	astrofizyk
rottweilerka	rottweiler
epigraficzka	epigrafik
snobka	snob
najmitka	najmita
parulatka	parulatek
wągrowczanka	wągrowczanin
Polka	Polak
farciara	farciarz
zastępczyni	zastępca
normalizatorka	normalizator
widząca	widzący
wronczanka	wronczanin
Indianka Keczua	Indianin Keczua
gaullistka	gaullista
władczyni	władca
modernizatorka	modernizator
zatorzanka	zatorzanin
dziennikarka śledcza	dziennikarz śledczy
Lasowiaczka	Lasowiak
utrakwistka	utrakwista
kryniczanka	kryniczanin
komarzyca	komar
ateistka	ateista
bandytka	bandyta
dziewiarka	dziewiarz
rejestratorka	rejestrator
plebejka	plebejusz
prymuska	prymus
aulistka	aulista
dojarka	dojarz
weganka	weganin
odpowiedniczka	odpowiednik
czterolatka	czterolatek
Belizenka	Belizeńczyk
treserka	treser
instalatorka	instalator
poliamoryczka	poliamoryk
białostoczanka	białostoczanin
Drawidyjka	Drawida
pieszczocha	pieszczoch
Pepiczka	Pepiczek
społecznica	społecznik
mazurzystka	mazurzysta
znalazczyni	znalazca
szansonistka	szansonista
adwersarka	adwersarz
bytomianka	bytomianin
ekspedytorka	ekspedytor
prekursorka	prekursor
straganiarka	straganiarz
legionowianka	legionowianin
żmigrodzianka	żmigrodzianin
niszczycielka	niszczyciel
bileterka	bileter
morfinistka	morfinista
wiedenka	wiedeńczyk
rolniczka	rolnik
Koptyjka	Kopt
gazdyni	gazda
dropiata	dropiaty
ateuszka	ateusz
potakiwaczka	potakiwacz
Azteczka	Aztek
pomocniczka	pomocnik
żołnierka	żołnierz
dwuboistka	dwuboista
odstępczyni	odstępca
skarogniada	skarogniady
atletka	atleta
bukieciarka	bukieciarz
wróblica	wróbel
nudziara	nudziarz
kilimiarka	kilimiarz
glosatorka	glosator
parafianka	parafianin
liderka	lider
chełmianka	chełmianin
świntucha	świntuch
pieszczoszka	pieszczoszek
pochlebczyni	pochlebca
intuicjonistka	intuicjonista
dowcipnisia	dowcipniś
barwiczanka	barwiczanin
szybkobiegaczka	szybkobiegacz
dziewięciolatka	dziewięciolatek
bagdadka	bagdadczyk
ośmiolatka	ośmiolatek
łachmaniarka	łachmaniarz
głuszyca	głuszec
łodzianka	łodzianin
anglofilka	anglofil
męczenniczka	męczennik
Jawanka	Jawańczyk
przewoźniczka	przewoźnik
zarządczyni	zarządca
horodyszczanka	horodyszczanin
znachorka	znachor
interwentka	interwent
jedenastolatka	jedenastolatek
sentymentalistka	sentymentalista
Aragonka	Aragończyk
furfantka	furfant
stażystka	stażysta
dworka	dworak
dialektolożka	dialektolog
młódka	młodzik
warsztatowiczka	warsztatowicz
lwica	lew
adiustatorka	adiustator
kultystka	kultysta
oferentka	oferent
biurokratka	biurokrata
sewilka	sewilczyk
Kaszmirka	Kaszmirczyk
psychotyczka	psychotyk
strażniczka ochrony kolei	strażnik ochrony kolei
abakanka	abakańczyk
ostrzeszowianka	ostrzeszowianin
krojczyni	krojczy
łukowiczanka	łukowiczanin
topielica	topielec
augustianka	augustianin
cholewkarka	cholewkarz
kuzynka	kuzyn
bibliofilka	bibliofil
bakijka	bakijczyk
logopedka	logopeda
moderatorka	moderator
konsumentka	konsument
zwodzicielka	zwodziciel
łączniczka	łącznik
szesnastolatka	szesnastolatek
ryżanka	ryżanin
cierpiąca	cierpiący
czytelniczka	czytelnik
branka	braniec
Laotanka	Laotańczyk
kilkunastolatka	kilkunastolatek
kłodzczanka	kłodzczanin
Sławianka	Sławianin
oboistka	oboista
zesłanka	zesłaniec
labradorka	labrador
podchorąża	podchorąży
autsajderka	autsajder
Masajka	Masaj
kuratorka	kurator
twórczyni	twórca
wyzwolicielka	wyzwoliciel
przeklętnica	przeklętnik
liliputka	liliput
obozowiczka	obozowicz
sztajmeska	sztajmes
Afganka	Afgan
flecistka	flecista
doktorka	doktór
pogromczyni	pogromca
panująca	panujący
cudotwórczyni	cudotwórca
prezeska	prezes
naczelniczka	naczelnik
Tadżyjka	Tadżyk
puławianka	puławianin
chojniczanka	chojniczanin
ochotniczka	ochotnik
apologetka	apologeta
tupeciara	tupeciarz
faktorka	faktor
romantyczka	romantyk
szyfrantka	szyfrant
biedniaczka	biedniak
rejentka	rejent
swawolnica	swawolnik
zawiadowczyni	zawiadowca
religiantka	religiant
akrobatka	akrobata
konfidentka	konfident
parodystka	parodysta
Mazowszanka	Mazowszanin
karaitka	karaita
lancasterka	lancasterczyk
bohaterka	bohater
winiarka	winiarz
krupiarka	krupiarz
doręczycielka	doręczyciel
Zimbabwejka	Zimbabwejczyk
bratanica	bratanek
pabianiczanka	pabianiczanin
dyletantka	dyletant
alwernianka	alwernianin
żonglerka	żongler
zwiedzająca	zwiedzający
dermatolożka	dermatolog
inscenizatorka	inscenizator
Słowianka	Słowianin
bolesławianka	bolesławianin
następczyni tronu	następca tronu
specjalistka	specjalista
rzeźniczka	rzeźnik
dziedziczka	dziedzic
Tajlandka	Tajlandczyk
pojmana	pojmany
reformatorka	reformator
Eskimoska	Eskimos
strumienianka	strumienianin
akwizytorka	akwizytor
napastniczka	napastnik
trzynastolatka	trzynastolatek
krajanka	krajan
farbiarka	farbiarz
wczasowiczka	wczasowicz
współuczennica	współuczeń
miniaturzystka	miniaturzysta
Siuksyjka	Siuks
zieleniarka	zieleniarz
przodowniczka pracy	przodownik pracy
skautka	skaut
islamistka	islamista
epizodystka	epizodysta
wieszczbiarka	wieszczbiarz
razemitka	razemita
delikwentka	delikwent
dworaczka	dworak
matkobójczyni	matkobójca
banitka	banita
spikerka	spiker
Hotentotka	Hotentot
żeglarka	żeglarz
szintoistka	szintoista
gospodyni	gospodarz
rządczyni	rządca
arystokratka	arystokrata
eurodeputowana	eurodeputowany
chrzanowianka	chrzanowianin
panikara	panikarz
Bernenka	Berneńczyk
kwakierka	kwakier
biegaczka	biegacz
płaczka	płaczek
debilka	debil
starsza	starszy
bankierka	bankier
biskupka	biskup
rozbójniczka	rozbójnik
tallinka	tallińczyk
juniorka	junior
obsesjonatka	obsesjonat
ekspertka	ekspert
ubezpieczona	ubezpieczony
Podlasianka	Podlasianin
partnerka	partner
oszustka	oszust
komisantka	komisant
sukcesorka	sukcesor
jankeska	jankes
gazdynia	gazda
informatyczka	informatyk
lizuska	lizus
hiperrealistka	hiperrealista
tomaszowianka	tomaszowianin
bukownianka	bukownianin
esperantystka	esperantysta
bookmacherka	bookmacher
macherka	macher
kopenhażanka	kopenhażanin
retuszerka	retuszer
menedżerka	menedżer
bolonka	bolończyk
Sybiraczka	Sybirak
inkwizytorka	inkwizytor
oszczepniczka	oszczepnik
trapezistka	trapezista
ratlerka	ratler
boboliczanka	boboliczanin
dzika lokatorka	dziki lokator
Arabka Saudyjska	Arab Saudyjski
ciułaczka	ciułacz
eksternistka	eksternista
dziesięcioboistka	dziesięcioboista
dziesięciolatka	dziesięciolatek
raciborzanka	raciborzanin
protestantka	protestant
demagożka	demagog
buntowniczka	buntownik
Dalmatynka	Dalmatyńczyk
centralistka	centralista
kuśnierka	kuśnierz
kłodawianka	kłodawianin
katechetka	katecheta
wałbrzyszanka	wałbrzyszanin
Buszmenka	Buszmen
drugoklasistka	drugoklasista
uchodźczyni	uchodźca
antenatka	antenat
sołtyska	sołtys
biedula	biedak
sterniczka	sternik
eseistka	eseista
Sanmarynka	Sanmaryńczyk
Elamitka	Elamita
kamaszniczka	kamasznik
bielawianka	bielawianin
architektka wnętrz	architekt wnętrz
dziesiętniczka	dziesiętnik
bibliotekarka	bibliotekarz
Zagórzanka	Zagórzanin
przodkini	przodek
bratobójczyni	bratobójca
turystka	turysta
królica	królik
katoliczka	katolik
ekskomunistka	ekskomunista
fanatyczka	fanatyk
rabczanka	rabczanin
naśladowczyni	naśladowca
sławianka	sławianin
markierantka	markierant
warszawianka	warszawianin
kowbojka	kowboj
bluźnierczyni	bluźnierca
egoistka	egoista
demonolożka	demonolog
dozorczyni	dozorca
wilczyca	wilk
awanturnica	awanturnik
szopenistka	szopenista
moskwianka	moskwianin
Izraelitka	Izraelita
cholernica	cholernik
surferka	surfer
Komanczka	Komancz
austrofobka	austrofob
Brazylijka	Brazylijczyk
Europejka	Europejczyk
Rakuszanka	Rakuszanin
ranna	ranny
palotynka	palotyn
legniczanka	legniczanin
kanciara	kanciarz
profesorka	profesor
telegrafistka	telegrafista
republikanka	republikanin
fizyczka	fizyk
lwowianka	lwowianin
fiksatka	fiksat
nonkonformistka	nonkonformista
Mazurka	Mazur
doktorka	doktor
współćwicząca	współćwiczący
niewierząca	niewierzący
businesswoman	businessman
trzylatka	trzylatek
przodowniczka	przodownik
filomatka	filomata
pesymistka	pesymista
Estonka	Estończyk
jakszini	jaksza
pamiętnikarka	pamiętnikarz
taborytka	taboryta
leszcznianka	leszcznianin
ćpunka	ćpun
naiwniaczka	naiwniak
eksploratorka	eksplorator
Azerka	Azer
tarnowianka	tarnowianin
abonentka	abonent
trenerka	trener
lubinianka	lubinianin
caryca	car
kochana	kochany
astmatyczka	astmatyk
współsprawczyni	współsprawca
chichotka	chichot
okrutnica	okrutnik
slawistka	slawista
szpitalnica	szpitalnik
katechumenka	katechumen
turynka	turyńczyk
szczeniara	szczeniak
kinomanka	kinoman
spowinowacona	spowinowacony
rebeliantka	rebeliant
porywaczka	porywacz
asekuratorka	asekurator
akuszerka	akuszer
repatriantka	repatriant
wierzycielka	wierzyciel
brańszczanka	brańszczanin
piętnastolatka	piętnastolatek
drohobyczanka	drohobyczanin
odkrywczyni	odkrywca
zmarła	zmarły
lobbystka	lobbysta
dostarczycielka	dostarczyciel
pilźnianka	pilźnianin
postulantka	postulant
restauratorka	restaurator
trzydziestolatka	trzydziestolatek
księgowa	księgowy
demaskatorka	demaskator
dystrybutorka	dystrybutor
wioślarka	wioślarz
tarnobrzeżanka	tarnobrzeżanin
wyrobniczka	wyrobnik
fotomodelka	fotomodel
Czerkieska	Czerkies
chrześcijanka	chrześcijanin
pomysłodawczyni	pomysłodawca
sprawicielka	sprawiciel
Asyryjka	Asyryjczyk
utracjuszka	utracjusz
transseksualistka	transseksualista
Botswanka	Botswańczyk
koadiutorka	koadiutor
naziolka	naziol
futbolistka	futbolista
Liberyjka	Liberyjczyk
spirytystka	spirytysta
festiwalowiczka	festiwalowicz
popleczniczka	poplecznik
inwentaryzatorka	inwentaryzator
pieniaczka	pieniacz
surrealistka	surrealista
cyganolożka	cyganolog
współobywatelka	współobywatel
kuracjuszka	kuracjusz
modelatorka	modelator
mielczanka	mielczanin
sześćdziesięciolatka	sześćdziesięciolatek
przywłaszczycielka	przywłaszczyciel
konserwatystka	konserwatysta
analfabetka	analfabeta
Erytrejka	Erytrejczyk
Kozaczka	Kozak
filmoznawczyni	filmoznawca
guślarka	guślarz
podrywaczka	podrywacz
krasomówczyni	krasomówca
współtowarzyszka	współtowarzysz
instrumentalistka	instrumentalista
garderobiana	garderobiany
klawesynistka	klawesynista
dwudziestoparolatka	dwudziestoparolatek
szmuglerka	szmugler
realizatorka	realizator
Apaczka	Apacz
grudziądzanka	grudziądzanin
jazzmanka	jazzman
Ślązaczka	Ślązak
dadaistka	dadaista
lesznianka	lesznianin
zduńskowolanka	zduńskowolanin
wróżbitka	wróżbita
tradycjonalistka	tradycjonalista
hebraistka	hebraista
marszandka	marszand
motocyklistka	motocyklista
kalikstynka	kalikstyn
Abchazka	Abchaz
bramkarka	bramkarz
podatniczka	podatnik
myśleniczanka	myśleniczanin
allegrowiczka	allegrowicz
Hucułka	Hucuł
arogantka	arogant
figurantka	figurant
koordynatorka	koordynator
diabetolożka	diabetolog
waszyngtonka	waszyngtończyk
kalwinistka	kalwinista
posłanniczka	posłannik
powiernica	powiernik
egzaminatorka	egzaminator
Polinezyjka	Polinezyjczyk
mniszka	mnich
Kanadyjka	Kanadyjczyk
prokuratorka	prokurator
miotaczka	miotacz
latynistka	latynista
pekinka	pekińczyk
Czechosłowaczka	Czechosłowak
giżycczanka	giżycczanin
chojnowianka	chojnowianin
manifestantka	manifestant
hipiska	hipis
połykaczka	połykacz
Mandżurka	Mandżur
wiceprzewodnicząca	wiceprzewodniczący
bananówka	banan
Urugwajka	Urugwajczyk
Albanka	Albańczyk
telefonistka	telefonista
Barbadoska	Barbadoszczyk
administratorka	administrator
wtajemniczona	wtajemniczony
pieguska	piegus
młociarka	młociarz
falsyfikatorka	falsyfikator
antagonistka	antagonista
kontrabasistka	kontrabasista
Wenusjanka	Wenusjanin
eskapistka	eskapista
agregatka	agregat
Atenka	Ateńczyk
organistka	organista
taksonomistka	taksonomista
bridżystka	bridżysta
windziarka	windziarz
wizytatorka	wizytator
eklektyczka	eklektyk
lakierniczka	lakiernik
dominikanka	dominikanin
pawłowiczanka	pawłowiczanin
antyfaszystka	antyfaszysta
przyboczna	przyboczny
Szoszonka	Szoszon
utrzymanka	utrzymanek
rojalistka	rojalista
piekielnica	piekielnik
bursztyniarka	bursztyniarz
perukarka	perukarz
liberalistka	liberalista
Namibijka	Namibijczyk
abnegatka	abnegat
dortmundka	dortmundczyk
Algierka	Algierczyk
karierka	karier
agronomka	agronom
kokieta	kokiet
Armenka	Armeńczyk
przedmówczyni	przedmówca
czterdziestolatka	czterdziestolatek
kolekcjonerka	kolekcjoner
beneficjantka	beneficjant
menadżerka	menadżer
Angolka	Angolczyk
pasierbica	pasierb
egiptolożka	egiptolog
milusińska	milusiński
mieszczanka	mieszczanin
fatalistka	fatalista
wierząca	wierzący
poznaniaczka	poznaniak
krętaczka	krętacz
fotoamatorka	fotoamator
Szkotka	Szkot
chórzystka	chórzysta
inwigilatorka	inwigilator
łabędzica	łabędź
aborterka	aborter
nosicielka	nosiciel
krupierka	krupier
konformistka	konformista
diarystka	diarysta
pustelniczka	pustelnik
pierwszoklasistka	pierwszoklasista
mścicielka	mściciel
Waszyngtonka	Waszyngtończyk
łacinniczka	łacinnik
Kurpianka	Kurp
abstrakcjonistka	abstrakcjonista
redaktor naczelny	redaktor naczelna
judaistka	judaista
wolna słuchaczka	wolny słuchacz
asystentka	asystent
rutenistka	rutenista
nastawnicza	nastawniczy
gołębiarka	gołębiarz
europosłanka	europoseł
Niemka	Niemiec
gimnazistka	gimnazista
szpiegówka	szpieg
fundamentalistka	fundamentalista
niewolnica	niewolnik
patrycjuszka	patrycjusz
Syjamka	Syjamczyk
limanowianka	limanowianin
kalwarianka	kalwarianin
populistka	populista
druhna	drużba
waterpolistka	waterpolista
pokutniczka	pokutnik
Persyjka	Pers
baronessa	baron
innowatorka	innowator
autostopowiczka	autostopowicz
ofiarodawczyni	ofiarodawca
arytmetyczka	arytmetyk
demistyfikatorka	demistyfikator
techniczka	technik
ostrowianka	ostrowianin
prusaczka	prusak
sztukmistrzyni	sztukmistrz
szczecinianka	szczecinianin
florentynka	florentyńczyk
pupilka	pupil
polityczka	polityk
pacjentka	pacjent
obrazoburczyni	obrazoburca
jurystka	jurysta
bogaczka	bogacz
Tuwalka	Tuwalczyk
lobbistka	lobbista
poligamistka	poligamista
biegła	biegły
Nauranka	Naurańczyk
komediopisarka	komediopisarz
iluzjonistka	iluzjonista
militarystka	militarysta
anglofobka	anglofob
miłośnica	miłośnik
aborcjonistka	aborcjonista
wstępna	wstępny
wiolonczelistka	wiolonczelista
Zelandka	Zelandczyk
Mordwinka	Mordwin
improwizatorka	improwizator
mentorka	mentor
weredyczka	weredyk
dywizjonistka	dywizjonista
siewczyni	siewca
kadetka	kadet
asekurantka	asekurant
konwencjonalistka	konwencjonalista
wysłannica	wysłannik
wróżbiarka	wróżbiarz
dokumentalistka	dokumentalista
odnowicielka	odnowiciel
Kolumbijka	Kolumbijczyk
nieszczęśnica	nieszczęśnik
kolatorka	kolator
harfistka	harfista
efekciara	efekciarz
posłanka	poseł
gałganiarka	gałganiarz
Gagauzka	Gagauz
kłótnica	kłótnik
parlamentarzystka	parlamentarzysta
nowatorka	nowator
entuzjastka	entuzjasta
elfka	elf
raptuska	raptus
seniorka	senior
krzywdzicielka	krzywdziciel
prowincjałka	prowincjał
rozkrzewicielka	rozkrzewiciel
krzewicielka	krzewiciel
Nikaraguanka	Nikaraguańczyk
neofaszystka	neofaszysta
idealistka	idealista
pokutnica	pokutnik
sosnowczanka	sosnowczanin
działkowiczka	działkowicz
oberżystka	oberżysta
Szauniska	Szaunis
Malezyjka	Malezyjczyk
pedantka	pedant
migrantka	migrant
nieudacznica	nieudacznik
brześcianka	brześcianin
pawica	paw
finalistka	finalista
krośnianka	krośnianin
habilitantka	habilitant
unitka	unita
iłżanka	iłżanin
detektorystka	detektorysta
Holenderka	Holender
deportowana	deportowany
fagocistka	fagocista
poprzednica	poprzednik
wózkarka	wózkarz
bremenka	bremeńczyk
metalówka	metalowiec
rusycystka	rusycysta
synoptyczka	synoptyk
kreślarka	kreślarz
droga	drogi
Syberyjka	Syberyjczyk
Kreolka	Kreol
analityczka	analityk
erudytka	erudyta
brydżystka	brydżysta
Malediwka	Malediwczyk
Barbadosyjka	Barbadosyjczyk
cukierniczka	cukiernik
jedyna	jedyny
trucicielka	truciciel
szlachcianka	szlachcic
prażanka	prażanin
katotalibka	katotalib
Baszkirka	Baszkir
benedyktynka	benedyktyn
oponentka	oponent
wspomożycielka	wspomożyciel
owowegetarianka	owowegetarianin
przedsiębiorczyni	przedsiębiorca
letniczka	letnik
markietanka	markietan
wajdelotka	wajdelota
stygmatyczka	stygmatyk
szantażystka	szantażysta
służebna	służebny
charakteryzatorka	charakteryzator
bulterierka	bulterier
gobeliniarka	gobeliniarz
tramwajarka	tramwajarz
postkomunistka	postkomunista
dochtorka	dochtor
meteorolożka	meteorolog
grzbiecistka	grzbiecista
słowianoznawczyni	słowianoznawca
fotograficzka	fotografik
bałaganiara	bałaganiarz
bałamutka	bałamut
witarianka	witarianin
adresatka	adresat
bigotka	bigot
lewaczka	lewak
tuziemka	tuziemiec
artystka ludowa	artysta ludowy
naturystka	naturysta
ostatnia	ostatni
dręczycielka	dręczyciel
kontestatorka	kontestator
pedicurzystka	pedicurzysta
patriarchini	patriarcha
sanmarynka	sanmaryńczyk
Finka	Fin
weteranka	weteran
agrochemiczka	agrochemik
programistka	programista
automobilistka	automobilista
kutnianka	kutnianin
Portorykanka	Portorykańczyk
medalistka	medalista
protagonistka	protagonista
kusicielka	kusiciel
apostołka	apostoł
seksistka	seksista
krakowiaczka	krakowiak
chodziarka	chodziarz
szafarka	szafarz
Gibraltarka 	Gibraltarczyk
obywatelka	obywatel
ignorantka	ignorant
hedonistka	hedonista
witniczanka	witniczanin
pracownica służby zdrowia	pracownik służby zdrowia
ukoicielka	ukoiciel
dezynfektorka	dezynfektor
fotoreporterka	fotoreporter
paskarka	paskarz
cybernetyczka	cybernetyk
stylistka	stylista
operatorka kamery	operator kamery
rówieśnica	rówieśnik
radomszczanka	radomszczanin
ascendentka	ascendent
słonica	słoń
decydentka	decydent
jarosławianka	jarosławianin
kabotynka	kabotyn
łodygowiczanka	łodygowiczanin
ekspatriantka	ekspatriant
Montserratka	Montserratczyk
zielonogórzanka	zielonogórzanin
cyrkówka	cyrkowiec
tarnogórzanka	tarnogórzanin
dwórka	dworak
graczka	gracz
dekadentka	dekadent
Serbka	Serb
kosmonautka	kosmonauta
nadawczyni	nadawca
elektromonterka	elektromonter
praktykantka	praktykant
kontrrewolucjonistka	kontrrewolucjonista
cukrzyczka	cukrzyk
librecistka	librecista
botaniczka	botanik
daleka krewna	daleki krewny
hrabianka	hrabicz
Papuanka	Papuańczyk
dilerka	diler
żałobnica	żałobnik
markiza	markiz
włościanka	włościanin
komiwojażerka	komiwojażer
ratowniczka	ratownik
latawica	latawiec
chiromantka	chiromanta
rekonwalescentka	rekonwalescent
Południowoafrykanka	Południowoafrykańczyk
rozwódka	rozwodnik
chroniczka	chronik
amatorka	amator
chimeryczka	chimeryk
grubianka	grubianin
denuncjatorka	denuncjator
planistka	planista
Sierraleonka	Sierraleończyk
polerowniczka	polerownik
lenniczka	lennik
pingpongistka	pingpongista
torunianka	torunianin
słodziutka	słodziutki
wetka	wet
Sumeryjka	Sumer
Beduinka	Beduin
biczowniczka	biczownik
nienormalna	nienormalny
tebanka	tebańczyk
